ZraI	GAC^GTC
XmaI	C^CCGGG
TspMI	C^CCGGG
StyD4I	^CCNGG
SfoI	GGC^GCC
SfcI	C^TRYAG
SbfI	CCTGCA^GG
Sau3AI	^GATC
PspOMI	G^GGCCC
PspGI	^CCWGG
PmlI	CAC^GTG
PluTI	GGCGC^C
PflFI	GACN^NNGTC
PciI	A^CATGT
PaeR7I	C^TCGAG
NsiI	ATGCA^T
NgoMIV	G^CCGGC
NdeII	^GATC
NciI	CC^SGG
MspI	C^CGG
MspA1I	CMG^CKG
MscI	TGG^CCA
MlyI	GAGTC
MluCI	^AATT
KasI	G^GCGCC
HpyCH4V	TG^CA
HpyCH4IV	A^CGT
HpyCH4III	ACN^GT
Hpy188III	TC^NNGA
Hpy166II	GTN^NAC
HinP1I	G^CGC
HincII	GTY^RAC
FspI	TGC^GCA
FatI	^CATG
Eco53kI	GAG^CTC
EagI	C^GGCCG
DraI	TTT^AAA
DpnII	^GATC
CviQI	G^TAC
CviKI-1	RG^CY
CviAII	C^ATG
BtsCI	GGATG
BtgI	C^CRYGG
Bsu36I	CC^TNAGG
BstZ17I	GTA^TAC
BstYI	R^GATCY
BstUI	CG^CG
BstNI	CC^WGG
BstBI	TT^CGAA
BstAPI	GCANNNN^NTGC
BssKI	^CCNGG
BssHII	G^CGCGC
BsrGI	T^GTACA
BsrFI	R^CCGGY
BspQI	GCTCTTC
BspEI	T^CCGGA
BspDI	AT^CGAT
Bsp1286I	GDGCH^C
BsoBI	C^YCGRG
BsmFI	GGGAC
BsmBI	CGTCTC
BslI	CCNNNNN^NNGG
BsiWI	C^GTACG
BsiHKAI	GWGCW^C
BsiEI	CGRY^CG
BsaWI	W^CCGGW
BsaJI	C^CNNGG
BsaI	GGTCTC
BsaHI	GR^CGYC
BpuEI	CTTGAG
BpmI	CTGGAG
BmtI	GCTAG^C
BmrI	ACTGGG
BmgBI	CACGTC
BlpI	GC^TNAGC
BfuCI	^GATC
BfuAI	ACCTGC
BfaI	C^TAG
BcoDI	GTCTC
BceAI	ACGGC
BbsI	GAAGAC
BanI	G^GYRCC
BaeGI	GKGCM^C
AsiSI	GCGAT^CGC
AseI	AT^TAAT
ApeKI	G^CWGC
AlwI	GGATC
AleI	CACNN^NNGTG
AhdI	GACNNN^NNGTC
AfeI	AGC^GCT
AcuI	CTGAAG
AccIII	T^CCGGA
AflIII	A^CRYGT
SexAI	A^CCWGGT
PshAI	GACNN^NNGTC
DdeI	C^TNAG
AvaII	G^GWCC
AgeI	A^CCGGT
AvaI	C^YCGRG
ScrFI	CC^NGG
BsmI	GAATGC
NarI	GG^CGCC
SwaI	ATTT^AAAT
HaeII	RGCGC^Y
AflII	C^TTAAG
SfaNI	GCATC
AclI	AA^CGTT
FauI	CCCGC
HgaI	GACGC
MfeI	C^AATTG
PsiI	TTA^TAA
PspXI	VC^TCGAGB
Tth111I	GACN^NNGTC
FokI	GGATG
PacI	TTAAT^TAA
HphI	GGTGA
AatII	GACGT^C
MboII	GAAGA
ApaLI	G^TGCAC
NaeI	GCC^GGC
SnaBI	TAC^GTA
BstEII	G^GTNACC
StyI	C^CWWGG
BclI	T^GATCA
RsaI	GT^AC
BglI	GCCNNNN^NGGC
SfiI	GGCCNNNN^NGGCC
MseI	T^TAA
ClaI	AT^CGAT
SacII	CCGC^GG
StuI	AGG^CCT
AccI	GT^MKAC
SpeI	A^CTAGT
HaeIII	GG^CC
PvuI	CGAT^CG
HhaI	GCG^C
NdeI	CA^TATG
XhoI	C^TCGAG
SacI	GAGCT^C
ApaI	GGGCC^C
MluI	A^CGCGT
DpnI	GA^TC
NruI	TCG^CGA
HpaI	GTT^AAC
SphI	GCATG^C
EcoRV	GAT^ATC
MboI	^GATC
ScaI	AGT^ACT
NcoI	C^CATGG
NotI	GC^GGCCGC
NheI	G^CTAGC
TaqI	T^CGA
SspI	AAT^ATT
HinfI	G^ANTC
BglII	A^GATCT
PvuII	CAG^CTG
AluI	AG^CT
BamHI	G^GATCC
EcoRI	G^AATTC
HindIII	A^AGCTT
KpnI	GGTAC^C
PstI	CTGCA^G
SalI	G^TCGAC
SmaI	CCC^GGG
XbaI	T^CTAGA
XmnI	GAANN^NNTTC
RsrII	CG^GWCCG
AciI	CCGC
AlwNI	CAGNNN^CTG
ApoI	R^AATTY
AscI	GG^CGCGCC
AvrII	C^CTAGG
BbvI	GCAGC
BbvCI	CCTCAGC
BccI	CCATC
BciVI	GTATCC
BsaAI	YAC^GTR
BsaBI	GATNN^NNATC
BseRI	GAGGAG
BseYI	CCCAGC
BsgI	GTGCAG
BsmAI	GTCTC
BspHI	T^CATGA
BspMI	ACCTGC
BsrI	ACTGG
BsrBI	CCGCTC
BsrDI	GCAATG
BtgZI	GCGATG
BtsIMutI	CAGTG
BtsI	GCAGTG
Cac8I	GCN^NGC
DrdI	GACNNNN^NNGTC
EciI	GGCGGA
EcoNI	CCTNN^NNNAGG
Fnu4HI	GC^NGC
FseI	GGCCGG^CC
Hpy99I	CGWCG^
Hpy188I	TCN^GA
LpnPI	CCDG
MmeI	TCCRAC
MslI	CAYNN^NNRTG
MspJI	CNNR
MwoI	GCNNNNN^NNGC
NlaIII	CATG^
NlaIV	GGN^NCC
NmeAIII	GCCGAG
NspI	RCATG^Y
PflMI	CCANNNN^NTGG
PleI	GAGTC
PmeI	GTTT^AAAC
PpuMI	RG^GWCCY
SapI	GCTCTTC
SgrAI	CR^CCGGYG
SmlI	C^TYRAG
TfiI	G^AWTC
TseI	G^CWGC
Tsp45I	^GTSAC
TspRI	CASTGNN^
XcmI	CCANNNNN^NNNNTGG
EcoP15I	CAGCAG
BanII	GRGCY^C
EaeI	Y^GGCCR
Sau96I	G^GNCC